a	a
afajdlj	abandon
afklkfj	ability
afld	able
aflffklj	abortion
afljf	about
aflfd	above
afflad	abroad
afsdjdd	absence
afslljfd	absolute
afslljfdlj	absolutely
afslff	absorb
afjsd	abuse
adaddjkd	academic
addd;f	accept
adddss	access
addkddjf	accident
addlj;ajj	accompany
addlj;lksj	accomplish
addlfdkjf	according
addljjf	account
addjfafd	accurate
addjsd	accuse
adjkdfd	achieve
adjkdfdjdjf	achievement
adkd	acid
adkjlslddfd	acknowledge
adajkfd	acquire
adflss	across
adf	act
adfklj	action
adfkfd	active
adfkfksf	activist
adfkfkfj	activity
adflf	actor
adffdss	actress
adfjal	actual
adfjallj	actually
ad	ad
ada;f	adapt
add	add
addkfklj	addition
addkfkljal	additional
addfdss	address
addajafd	adequate
adjjsf	adjust
adjjsfjdjf	adjustment
adjkjksffafklj	administration
adjkjksffaflf	administrator
adjkfd	admire
adjkssklj	admission
adjkf	admit
adlldsddjf	adolescent
adl;f	adopt
adjlf	adult
adfajdd	advance
adfajddd	advanced
adfajfafd	advantage
adfdjfjfd	adventure
adfdffkskjf	advertising
adfkdd	advice
adfksd	advise
adfksdf	adviser
adfldafd	advocate
affakf	affair
affddf	affect
afflfd	afford
affakd	afraid
affkdaj	African
affkdaj-ajdfkdaj	African-American
affdf	after
affdfjllj	afternoon
afakj	again
afakjsf	against
afd	age
afdjdj	agency
afdjda	agenda
afdjf	agent
afffdsskfd	aggressive
afl	ago
affdd	agree
affddjdjf	agreement
affkdjlfjfal	agricultural
aj	ah
ajdad	ahead
akd	aid
akdd	aide
akds	AIDS
akj	aim
akf	air
akfdfaff	aircraft
akflkjd	airline
akf;lff	airport
alfjj	album
aldljll	alcohol
alkfd	alive
all	all
allkajdd	alliance
allls	allow
allj	ally
aljlsf	almost
alljd	alone
alljf	along
alfdadj	already
alsl	also
alfdf	alter
alfdfjafkfd	alternative
alfjljfj	although
alsajs	always
aj	AM
ajaakjf	amazing
ajdfkdaj	American
ajljf	among
ajljjf	amount
ajaljsks	analysis
ajaljsf	analyst
ajaljad	analyze
ajdkdjf	ancient
ajd	and
ajfdf	anger
ajfld	angle
ajffj	angry
ajkjal	animal
ajjkfdfsafj	anniversary
ajjljjdd	announce
ajjjal	annual
ajlfjdf	another
ajssdf	answer
ajfkdk;afd	anticipate
ajskdfj	anxiety
ajj	any
ajjfldj	anybody
ajjjlfd	anymore
ajjljd	anyone
ajjfjkjf	anything
ajjsaj	anyway
ajjsjdfd	anywhere
a;aff	apart
a;affjdjf	apartment
a;;afdjf	apparent
a;;afdjflj	apparently
a;;dal	appeal
a;;daf	appear
a;;dafajdd	appearance
a;;ld	apple
a;;lkdafklj	application
a;;lj	apply
a;;lkjf	appoint
a;;lkjfjdjf	appointment
a;;fddkafd	appreciate
a;;fladj	approach
a;;fl;fkafd	appropriate
a;;flfal	approval
a;;flfd	approve
a;;flskjafdlj	approximately
afaf	Arab
afdjkfddf	architect
afda	area
affjd	argue
affjjdjf	argument
afksd	arise
afj	arm
afjdd	armed
afjj	army
afljjd	around
affajfd	arrange
affajfdjdjf	arrangement
affdsf	arrest
affkfal	arrival
affkfd	arrive
aff	art
affkdld	article
affksf	artist
affksfkd	artistic
as	as
askaj	Asian
askdd	aside
ask	ask
asldd;	asleep
as;ddf	aspect
assajlf	assault
assdff	assert
assdss	assess
assdssjdjf	assessment
assdf	asset
asskfj	assign
asskfjjdjf	assignment
assksf	assist
assksfajdd	assistance
assksfajf	assistant
assldkafd	associate
assldkafklj	association
assjjd	assume
assjj;fklj	assumption
assjfd	assure
af	at
afjldfd	athlete
afjldfkd	athletic
afjls;jdfd	atmosphere
affadj	attach
affadk	attack
affdj;f	attempt
affdjd	attend
affdjfklj	attention
affkfjdd	attitude
afflfjdj	attorney
afffadf	attract
afffadfkfd	attractive
afffkfjfd	attribute
ajdkdjdd	audience
ajfjlf	author
ajfjlfkfj	authority
ajfl	auto
afaklafld	available
afdfafd	average
aflkd	avoid
asafd	award
asafd	aware
asafdjdss	awareness
asaj	away
asfjl	awful
fafj	baby
fadk	back
fadkffljjd	background
fad	bad
fadlj	badly
faf	bag
fakd	bake
falajdd	balance
fall	ball
faj	ban
fajd	band
fajk	bank
faf	bar
fafdlj	barely
faffdl	barrel
faffkdf	barrier
fasd	base
fasdfall	baseball
faskd	basic
faskdallj	basically
fasks	basis
faskdf	basket
faskdffall	basketball
fafjfllj	bathroom
faffdfj	battery
faffld	battle
fd	be
fdadj	beach
fdaj	bean
fdaf	bear
fdaf	beat
fdajfkfjl	beautiful
fdajfj	beauty
fddajsd	because
fddljd	become
fdd	bed
fddfllj	bedroom
fddf	beer
fdflfd	before
fdfkj	begin
fdfkjjkjf	beginning
fdjafklf	behavior
fdjkjd	behind
fdkjf	being
fdlkdf	belief
fdlkdfd	believe
fdll	bell
fdlljf	belong
fdlls	below
fdlf	belt
fdjdj	bench
fdjd	bend
fdjdafj	beneath
fdjdfkf	benefit
fdskdd	beside
fdskdds	besides
fdsf	best
fdf	bet
fdffdf	better
fdfsddj	between
fdjljd	beyond
fkfld	Bible
fkf	big
fkkd	bike
fkll	bill
fkllklj	billion
fkjd	bind
fklllfkdal	biological
fkfd	bird
fkffj	birth
fkffjdaj	birthday
fkf	bit
fkfd	bite
fladk	black
fladd	blade
flajd	blame
flajkdf	blanket
flkjd	blind
flldk	block
fllld	blood
flls	blow
fljd	blue
flafd	board
flaf	boat
fldj	body
fljf	bomb
fljfkjf	bombing
fljd	bond
fljd	bone
fllk	book
fllj	boom
fllf	boot
flfddf	border
flfj	born
flffls	borrow
flss	boss
flfj	both
flfjdf	bother
flffld	bottle
flfflj	bottom
fljjdafj	boundary
flsl	bowl
fls	box
flj	boy
fljffkdjd	boyfriend
ffakj	brain
ffajdj	branch
ffajd	brand
ffdad	bread
ffdak	break
ffdakfasf	breakfast
ffdasf	breast
ffdafj	breath
ffdafjd	breathe
ffkdk	brick
ffkdfd	bridge
ffkdf	brief
ffkdflj	briefly
ffkfjf	bright
ffkllkajf	brilliant
ffkjf	bring
ffkfksj	British
fflad	broad
fflkdj	broken
fflfjdf	brother
fflsj	brown
ffjsj	brush
fjdk	buck
fjdfdf	budget
fjkld	build
fjkldkjf	building
fjlldf	bullet
fjjdj	bunch
fjfddj	burden
fjfj	burn
fjfj	bury
fjs	bus
fjskjdss	business
fjsj	busy
fjf	but
fjffdf	butter
fjfflj	button
fjj	buy
fjjdf	buyer
fj	by
dafkj	cabin
dafkjdf	cabinet
dafld	cable
dakd	cake
daldjlafd	calculate
dall	call
dajdfa	camera
daj;	camp
daj;akfj	campaign
daj;js	campus
daj	can
dajadkaj	Canadian
dajddf	cancer
dajdkdafd	candidate
da;	cap
da;afklkfj	capability
da;afld	capable
da;adkfj	capacity
da;kfal	capital
da;fakj	captain
da;fjfd	capture
daf	car
dafflj	carbon
dafd	card
dafd	care
dafddf	career
dafdfjl	careful
dafdfjllj	carefully
daffkdf	carrier
daffj	carry
dasd	case
dasj	cash
dasf	cast
daf	cat
dafdj	catch
dafdflfj	category
dafjllkd	Catholic
dajsd	cause
ddklkjf	ceiling
ddldffafd	celebrate
ddldffafklj	celebration
ddldffkfj	celebrity
ddll	cell
ddjfdf	center
ddjffal	central
ddjfjfj	century
ddl	CEO
ddfdjljj	ceremony
ddffakj	certain
ddffakjlj	certainly
djakj	chain
djakf	chair
djakfjaj	chairman
djalldjfd	challenge
djajfdf	chamber
djaj;klj	champion
djaj;kljsjk;	championship
djajdd	chance
djajfd	change
djajfkjf	changing
djajjdl	channel
dja;fdf	chapter
djafadfdf	character
djafadfdfksfkd	characteristic
djafadfdfkad	characterize
djaffd	charge
djafkfj	charity
djaff	chart
djasd	chase
djda;	cheap
djddk	check
djddk	cheek
djddsd	cheese
djdf	chef
djdjkdal	chemical
djdsf	chest
djkdkdj	chicken
djkdf	chief
djkld	child
djkldjlld	childhood
djkjdsd	Chinese
djk;	chip
djldllafd	chocolate
djlkdd	choice
djlldsfdfll	cholesterol
djllsd	choose
djfksfkaj	Christian
djfksfjas	Christmas
djjfdj	church
dkfafdffd	cigarette
dkfdld	circle
dkfdjjsfajdd	circumstance
dkfd	cite
dkfkadj	citizen
dkfj	city
dkfkl	civil
dkfklkaj	civilian
dlakj	claim
dlass	class
dlasskd	classic
dlassfllj	classroom
dldaj	clean
dldaf	clear
dldaflj	clearly
dlkdjf	client
dlkjafd	climate
dlkjf	climb
dlkjkd	clinic
dlkjkdal	clinical
dlldk	clock
dllsd	close
dllsdlj	closely
dllsdf	closer
dllfjds	clothes
dllfjkjf	clothing
dlljd	cloud
dljf	club
dljd	clue
dljsfdf	cluster
dladj	coach
dlal	coal
dlalkfklj	coalition
dlasf	coast
dlaf	coat
dldd	code
dlffdd	coffee
dlfjkfkfd	cognitive
dlld	cold
dllla;sd	collapse
dllldafjd	colleague
dlllddf	collect
dlllddfklj	collection
dlllddfkfd	collective
dllldfd	college
dllljkal	colonial
dlllf	color
dlljjj	column
dljfkjafklj	combination
dljfkjd	combine
dljd	come
dljddj	comedy
dljflff	comfort
dljflffafld	comfortable
dljjajd	command
dljjajddf	commander
dljjdjf	comment
dljjdfdkal	commercial
dljjkssklj	commission
dljjkf	commit
dljjkfjdjf	commitment
dljjkffdd	committee
dljjlj	common
dljjjjkdafd	communicate
dljjjjkdafklj	communication
dljjjjkfj	community
dlj;ajj	company
dlj;afd	compare
dlj;afkslj	comparison
dlj;dfd	compete
dlj;dfkfklj	competition
dlj;dfkfkfd	competitive
dlj;dfkflf	competitor
dlj;lakj	complain
dlj;lakjf	complaint
dlj;ldfd	complete
dlj;ldfdlj	completely
dlj;lds	complex
dlj;lkdafdd	complicated
dlj;ljdjf	component
dlj;lsd	compose
dlj;lskfklj	composition
dlj;fdjdjskfd	comprehensive
dlj;jfdf	computer
dljddjffafd	concentrate
dljddjffafklj	concentration
dljdd;f	concept
dljddfj	concern
dljddfjdd	concerned
dljddff	concert
dljdljdd	conclude
dljdljsklj	conclusion
dljdfdfd	concrete
dljdkfklj	condition
dljdjdf	conduct
dljfdfdjdd	conference
dljfkddjdd	confidence
dljfkddjf	confident
dljfkfj	confirm
dljflkdf	conflict
dljffljf	confront
dljfjsklj	confusion
dljffdss	Congress
dljffdsskljal	congressional
dljjddf	connect
dljjddfklj	connection
dljsdkljsjdss	consciousness
dljsdjsjs	consensus
dljsdajdjdd	consequence
dljsdffafkfd	conservative
dljskddf	consider
dljskddfafld	considerable
dljskddfafklj	consideration
dljsksf	consist
dljsksfdjf	consistent
dljsfajf	constant
dljsfajflj	constantly
dljsfkfjfd	constitute
dljsfkfjfkljal	constitutional
dljsffjdf	construct
dljsffjdfklj	construction
dljsjlfajf	consultant
dljsjjd	consume
dljsjjdf	consumer
dljsjj;fklj	consumption
dljfadf	contact
dljfakj	contain
dljfakjdf	container
dljfdj;lfafj	contemporary
dljfdjf	content
dljfdsf	contest
dljfdsf	context
dljfkjjd	continue
dljfkjjdd	continued
dljffadf	contract
dljffasf	contrast
dljffkfjfd	contribute
dljffkfjfklj	contribution
dljffll	control
dljfflfdfskal	controversial
dljfflfdfsj	controversy
dljfdjfklj	convention
dljfdjfkljal	conventional
dljfdfsafklj	conversation
dljfdff	convert
dljfkdfklj	conviction
dljfkjdd	convince
dllk	cook
dllkkd	cookie
dllkkjf	cooking
dlll	cool
dll;dfafklj	cooperation
dl;	cop
dl;d	cope
dl;j	copy
dlfd	core
dlfj	corn
dlfjdf	corner
dlf;lfafd	corporate
dlf;lfafklj	corporation
dlffddf	correct
dlffds;ljddjf	correspondent
dlsf	cost
dlfflj	cotton
dljdj	couch
dljld	could
dljjdkl	council
dljjsdllf	counselor
dljjf	count
dljjfdf	counter
dljjffj	country
dljjfj	county
dlj;ld	couple
dljfafd	courage
dljfsd	course
dljff	court
dljskj	cousin
dlfdf	cover
dlfdfafd	coverage
dls	cow
dfadk	crack
dfaff	craft
dfasj	crash
dfaaj	crazy
dfdaj	cream
dfdafd	create
dfdafklj	creation
dfdafkfd	creative
dfdafjfd	creature
dfddkf	credit
dfds	crew
dfkjd	crime
dfkjkjal	criminal
dfksks	crisis
dfkfdfka	criteria
dfkfkd	critic
dfkfkdal	critical
dfkfkdksj	criticism
dfkfkdkad	criticize
dfl;	crop
dflss	cross
dflsd	crowd
dfjdkal	crucial
dfj	cry
djlfjfal	cultural
djlfjfd	culture
dj;	cup
djfkljs	curious
djffdjf	current
djffdjflj	currently
djffkdjljj	curriculum
djsflj	custom
djsfljdf	customer
djf	cut
djdld	cycle
dad	dad
daklj	daily
dajafd	damage
dajdd	dance
dajfdf	danger
dajfdfljs	dangerous
dafd	dare
dafk	dark
dafkjdss	darkness
dafa	data
dafd	date
dajfjfdf	daughter
daj	day
ddad	dead
ddal	deal
ddaldf	dealer
ddaf	dear
ddafj	death
ddfafd	debate
ddff	debt
dddadd	decade
dddkdd	decide
dddksklj	decision
dddk	deck
dddlafd	declare
dddlkjd	decline
dddfdasd	decrease
ddd;	deep
ddd;lj	deeply
dddf	deer
ddfdaf	defeat
ddfdjd	defend
ddfdjdajf	defendant
ddfdjsd	defense
ddfdjskfd	defensive
ddfkdkf	deficit
ddfkjd	define
ddfkjkfdlj	definitely
ddfkjkfklj	definition
ddffdd	degree
ddlaj	delay
ddlkfdf	deliver
ddlkfdfj	delivery
ddjajd	demand
ddjldfadj	democracy
ddjldfaf	Democrat
ddjldfafkd	democratic
ddjljsffafd	demonstrate
ddjljsffafklj	demonstration
ddjj	deny
dd;affjdjf	department
dd;djd	depend
dd;djddjf	dependent
dd;djdkjf	depending
dd;kdf	depict
dd;fdssklj	depression
dd;fj	depth
dd;jfj	deputy
ddfkfd	derive
ddsdfkfd	describe
ddsdfk;fklj	description
ddsdff	desert
ddsdffd	deserve
ddskfj	design
ddskfjdf	designer
ddskfd	desire
ddsk	desk
dds;dfafd	desperate
dds;kfd	despite
ddsfflj	destroy
ddsffjdfklj	destruction
ddfakl	detail
ddfakldd	detailed
ddfddf	detect
ddfdfjkjd	determine
ddfdll;	develop
ddfdll;kjf	developing
ddfdll;jdjf	development
ddfkdd	device
ddflfd	devote
dkallfjd	dialogue
dkd	die
dkdf	diet
dkffdf	differ
dkffdfdjdd	difference
dkffdfdjf	different
dkffdfdjflj	differently
dkffkdjlf	difficult
dkffkdjlfj	difficulty
dkf	dig
dkfkfal	digital
dkjdjsklj	dimension
dkjkjf	dining
dkjjdf	dinner
dkfddf	direct
dkfddfklj	direction
dkfddflj	directly
dkfddflf	director
dkff	dirt
dkffj	dirty
dksafklkfj	disability
dksaffdd	disagree
dksa;;daf	disappear
dksasfdf	disaster
dksdk;lkjd	discipline
dksdljfsd	discourse
dksdlfdf	discover
dksdlfdfj	discovery
dksdfkjkjafklj	discrimination
dksdjss	discuss
dksdjssklj	discussion
dksdasd	disease
dksj	dish
dksjkss	dismiss
dkslfddf	disorder
dks;laj	display
dks;jfd	dispute
dksfajdd	distance
dksfajf	distant
dksfkjdf	distinct
dksfkjdfklj	distinction
dksfkjfjksj	distinguish
dksffkfjfd	distribute
dksffkfjfklj	distribution
dksffkdf	district
dkfdfsd	diverse
dkfdfskfj	diversity
dkfkdd	divide
dkfksklj	division
dkflfdd	divorce
dja	DNA
dl	do
dldflf	doctor
dldjjdjf	document
dlf	dog
dljdsfkd	domestic
dljkjajf	dominant
dljkjafd	dominate
dllf	door
dljfld	double
dljff	doubt
dlsj	down
dlsjflsj	downtown
dladj	dozen
dfaff	draft
dfaf	drag
dfaja	drama
dfajafkd	dramatic
dfajafkdallj	dramatically
dfas	draw
dfaskjf	drawing
dfdaj	dream
dfdss	dress
dfkjk	drink
dfkfd	drive
dfkfdf	driver
dfl;	drop
dfjf	drug
dfj	dry
djd	due
djfkjf	during
djsf	dust
djfj	duty
dadj	each
dafdf	eager
daf	ear
daflj	early
dafj	earn
dafjkjfs	earnings
daffj	earth
dasd	ease
dasklj	easily
dasf	east
dasfdfj	eastern
dasj	easy
daf	eat
ddljljkd	economic
ddljljkds	economics
ddljljksf	economist
ddljljj	economy
ddfd	edge
ddkfklj	edition
ddkflf	editor
ddjdafd	educate
ddjdafklj	education
ddjdafkljal	educational
ddjdaflf	educator
dffddf	effect
dffddfkfd	effective
dffddfkfdlj	effectively
dffkdkdjdj	efficiency
dffkdkdjf	efficient
dfflff	effort
dff	egg
dkfjf	eight
dkfjdf	either
dlddflj	elderly
dlddf	elect
dlddfklj	election
dlddffkd	electric
dlddffkdkfj	electricity
dlddffljkd	electronic
dldjdjf	element
dldjdjfafj	elementary
dlkjkjafd	eliminate
dlkfd	elite
dlsd	else
dlsdsjdfd	elsewhere
d-jakl	e-mail
djffadd	embrace
djdffd	emerge
djdffdjdj	emergency
djkssklj	emission
djlfklj	emotion
djlfkljal	emotional
dj;jasks	emphasis
dj;jaskad	emphasize
dj;llj	employ
dj;lljdd	employee
dj;lljdf	employer
dj;lljjdjf	employment
dj;fj	empty
djafld	enable
djdljjfdf	encounter
djdljfafd	encourage
djd	end
djdjj	enemy
djdffj	energy
djflfddjdjf	enforcement
djfafd	engage
djfkjd	engine
djfkjddf	engineer
djfkjddfkjf	engineering
djflksj	English
djjajdd	enhance
djjlj	enjoy
djlfjljs	enormous
djljfj	enough
djsjfd	ensure
djfdf	enter
djfdf;fksd	enterprise
djfdffakjjdjf	entertainment
djfkfd	entire
djfkfdlj	entirely
djffajdd	entrance
djffj	entry
djfkfljjdjf	environment
djfkfljjdjfal	environmental
d;ksldd	episode
dajal	equal
dajallj	equally
dajk;jdjf	equipment
dfa	era
dfflf	error
dsda;d	escape
ds;ddkallj	especially
dssaj	essay
dssdjfkal	essential
dssdjfkallj	essentially
dsfaflksj	establish
dsfaflksjjdjf	establishment
dsfafd	estate
dsfkjafd	estimate
dfd	etc
dfjkds	ethics
dfjjkd	ethnic
djfl;daj	European
dfaljafd	evaluate
dfaljafklj	evaluation
dfdj	even
dfdjkjf	evening
dfdjf	event
dfdjfjallj	eventually
dfdf	ever
dfdfj	every
dfdfjfldj	everybody
dfdfjdaj	everyday
dfdfjljd	everyone
dfdfjfjkjf	everything
dfdfjsjdfd	everywhere
dfkddjdd	evidence
dflljfklj	evolution
dfllfd	evolve
dsadf	exact
dsadflj	exactly
dsajkjafklj	examination
dsajkjd	examine
dsaj;ld	example
dsdddd	exceed
dsddlldjf	excellent
dsdd;f	except
dsdd;fklj	exception
dsdjajfd	exchange
dsdkfkjf	exciting
dsddjfkfd	executive
dsdfdksd	exercise
dsjkfkf	exhibit
dsjkfkfklj	exhibition
dsksf	exist
dsksfdjdd	existence
dsksfkjf	existing
ds;ajd	expand
ds;ajsklj	expansion
ds;ddf	expect
ds;ddfafklj	expectation
ds;djsd	expense
ds;djskfd	expensive
ds;dfkdjdd	experience
ds;dfkjdjf	experiment
ds;dff	expert
ds;lakj	explain
ds;lajafklj	explanation
ds;lldd	explode
ds;llfd	explore
ds;llsklj	explosion
ds;lsd	expose
ds;lsjfd	exposure
ds;fdss	express
ds;fdssklj	expression
dsfdjd	extend
dsfdjsklj	extension
dsfdjskfd	extensive
dsfdjf	extent
dsfdfjal	external
dsffa	extra
dsffalfdkjafj	extraordinary
dsffdjd	extreme
dsffdjdlj	extremely
djd	eye
faffkd	fabric
fadd	face
fadklkfj	facility
fadf	fact
fadflf	factor
fadflfj	factory
fadjlfj	faculty
fadd	fade
fakl	fail
fakljfd	failure
fakf	fair
fakflj	fairly
fakfj	faith
fall	fall
falsd	false
fajklkaf	familiar
fajklj	family
fajljs	famous
faj	fan
fajfasj	fantasy
faf	far
fafj	farm
fafjdf	farmer
fasjklj	fashion
fasf	fast
faf	fat
fafd	fate
fafjdf	father
fajlf	fault
faflf	favor
faflfkfd	favorite
fdaf	fear
fdafjfd	feature
fdddfal	federal
fdd	fee
fddd	feed
fddl	feel
fddlkjf	feeling
fdllls	fellow
fdjald	female
fdjdd	fence
fds	few
fdsdf	fewer
fkfdf	fiber
fkdfklj	fiction
fkdld	field
fkffddj	fifteen
fkffj	fifth
fkffj	fifty
fkfjf	fight
fkfjfdf	fighter
fkfjfkjf	fighting
fkfjfd	figure
fkld	file
fkll	fill
fklj	film
fkjal	final
fkjallj	finally
fkjajdd	finance
fkjajdkal	financial
fkjd	find
fkjdkjf	finding
fkjd	fine
fkjfdf	finger
fkjksj	finish
fkfd	fire
fkfj	firm
fkfsf	first
fksj	fish
fksjkjf	fishing
fkf	fit
fkfjdss	fitness
fkfd	five
fks	fix
flaf	flag
flajd	flame
flaf	flat
flaflf	flavor
fldd	flee
fldsj	flesh
flkfjf	flight
fllaf	float
flllf	floor
flls	flow
fllsdf	flower
flj	fly
fldjs	focus
fllk	folk
flllls	follow
fllllskjf	following
flld	food
fllf	foot
fllffall	football
flf	for
flfdd	force
flfdkfj	foreign
flfdsf	forest
flfdfdf	forever
flffdf	forget
flfj	form
flfjal	formal
flfjafklj	formation
flfjdf	former
flfjjla	formula
flffj	forth
flffjjd	fortune
flfsafd	forward
fljjd	found
fljjdafklj	foundation
fljjddf	founder
fljf	four
fljffj	fourth
ffajd	frame
ffajdslfk	framework
ffdd	free
ffdddlj	freedom
ffddad	freeze
ffdjdj	French
ffdajdjdj	frequency
ffdajdjf	frequent
ffdajdjflj	frequently
ffdsj	fresh
ffkdjd	friend
ffkdjdlj	friendly
ffkdjdsjk;	friendship
fflj	from
ffljf	front
ffjkf	fruit
ffjsffafklj	frustration
fjdl	fuel
fjll	full
fjllj	fully
fjj	fun
fjjdfklj	function
fjjd	fund
fjjdajdjfal	fundamental
fjjdkjf	funding
fjjdfal	funeral
fjjjj	funny
fjfjkfjfd	furniture
fjffjdfjlfd	furthermore
fjfjfd	future
fakj	gain
falasj	galaxy
falldfj	gallery
fajd	game
fajf	gang
fa;	gap
fafafd	garage
fafddj	garden
faflkd	garlic
fas	gas
fafd	gate
fafjdf	gather
faj	gay
faad	gaze
fdaf	gear
fdjddf	gender
fdjd	gene
fdjdfal	general
fdjdfallj	generally
fdjdfafd	generate
fdjdfafklj	generation
fdjdfkd	genetic
fdjfldjaj	gentleman
fdjflj	gently
fdfjaj	German
fdsfjfd	gesture
fdf	get
fjlsf	ghost
fkajf	giant
fkff	gift
fkffdd	gifted
fkfl	girl
fkflffkdjd	girlfriend
fkfd	give
fkfdj	given
flad	glad
flajdd	glance
flass	glass
fllfal	global
fllfd	glove
fl	go
flal	goal
fld	God
flld	gold
fllddj	golden
fllf	golf
flld	good
flfdfjjdjf	government
flfdfjlf	governor
ffaf	grab
ffadd	grade
ffadjallj	gradually
ffadjafd	graduate
ffakj	grain
ffajd	grand
ffajdfafjdf	grandfather
ffajdjlfjdf	grandmother
ffajf	grant
ffass	grass
ffafd	grave
ffaj	gray
ffdaf	great
ffdafdsf	greatest
ffddj	green
fflddfj	grocery
ffljjd	ground
fflj;	group
ffls	grow
fflskjf	growing
fflsfj	growth
fjafajfdd	guarantee
fjafd	guard
fjdss	guess
fjdsf	guest
fjkdd	guide
fjkddlkjd	guideline
fjklfj	guilty
fjj	gun
fjj	guy
jafkf	habit
jafkfaf	habitat
jakf	hair
jalf	half
jall	hall
jajd	hand
jajdfjl	handful
jajdld	handle
jajf	hang
ja;;dj	happen
ja;;j	happy
jafd	hard
jafdlj	hardly
jaf	hat
jafd	hate
jafd	have
jd	he
jdad	head
jdadlkjd	headline
jdadajaffdfs	headquarters
jdalfj	health
jdalfjj	healthy
jdaf	hear
jdafkjf	hearing
jdaff	heart
jdaf	heat
jdafdj	heaven
jdafklj	heavily
jdafj	heavy
jddl	heel
jdkfjf	height
jdlkdl;fdf	helicopter
jdll	hell
jdlll	hello
jdl;	help
jdl;fjl	helpful
jdf	her
jdfd	here
jdfkfafd	heritage
jdfl	hero
jdfsdlf	herself
jdj	hey
jk	hi
jkdd	hide
jkfj	high
jkfjlkfjf	highlight
jkfjlj	highly
jkfjsaj	highway
jkll	hill
jkj	him
jkjsdlf	himself
jk;	hip
jkfd	hire
jks	his
jksflfkaj	historian
jksflfkd	historic
jksflfkdal	historical
jksflfj	history
jkf	hit
jlld	hold
jlld	hole
jllkdaj	holiday
jllj	holy
jljd	home
jljdldss	homeless
jljdsf	honest
jljdj	honey
jljlf	honor
jl;d	hope
jlfkalj	horizon
jlfflf	horror
jlfsd	horse
jls;kfal	hospital
jlsf	host
jlf	hot
jlfdl	hotel
jljf	hour
jljsd	house
jljsdjlld	household
jljskjf	housing
jls	how
jlsdfdf	however
jjfd	huge
jjjaj	human
jjjlf	humor
jjjdfdd	hundred
jjjffj	hungry
jjjfdf	hunter
jjjfkjf	hunting
jjff	hurt
jjsfajd	husband
jj;lfjdsks	hypothesis
k	I
kdd	ice
kdda	idea
kddal	ideal
kddjfkfkdafklj	identification
kddjfkfj	identify
kddjfkfj	identity
kd	ie
kf	if
kfjlfd	ignore
kll	ill
klldfal	illegal
klljdss	illness
klljsffafd	illustrate
kjafd	image
kjafkjafklj	imagination
kjafkjd	imagine
kjjddkafd	immediate
kjjddkafdlj	immediately
kjjkffajf	immigrant
kjjkffafklj	immigration
kj;adf	impact
kj;ldjdjf	implement
kj;lkdafklj	implication
kj;lj	imply
kj;lffajdd	importance
kj;lffajf	important
kj;lsd	impose
kj;lsskfld	impossible
kj;fdss	impress
kj;fdssklj	impression
kj;fdsskfd	impressive
kj;flfd	improve
kj;flfdjdjf	improvement
kj	in
kjddjfkfd	incentive
kjdkddjf	incident
kjdljdd	include
kjdljdkjf	including
kjdljd	income
kjdlf;lfafd	incorporate
kjdfdasd	increase
kjdfdasdd	increased
kjdfdaskjf	increasing
kjdfdaskjflj	increasingly
kjdfddkfld	incredible
kjdddd	indeed
kjdd;djddjdd	independence
kjdd;djddjf	independent
kjdds	index
kjdkaj	Indian
kjdkdafd	indicate
kjdkdafklj	indication
kjdkfkdjal	individual
kjdjsffkal	industrial
kjdjsffj	industry
kjfajf	infant
kjfddfklj	infection
kjflafklj	inflation
kjfljdjdd	influence
kjflfj	inform
kjflfjafklj	information
kjffddkdjf	ingredient
kjkfkal	initial
kjkfkallj	initially
kjkfkafkfd	initiative
kjjjfj	injury
kjjdf	inner
kjjlddjf	innocent
kjajkfj	inquiry
kjskdd	inside
kjskfjf	insight
kjsksf	insist
kjs;kfd	inspire
kjsfall	install
kjsfajdd	instance
kjsfdad	instead
kjsfkfjfklj	institution
kjsfkfjfkljal	institutional
kjsffjdfklj	instruction
kjsffjdflf	instructor
kjsffjjdjf	instrument
kjsjfajdd	insurance
kjfdllddfjal	intellectual
kjfdllkfdjdd	intelligence
kjfdjd	intend
kjfdjsd	intense
kjfdjskfj	intensity
kjfdjfklj	intention
kjfdfadfklj	interaction
kjfdfdsf	interest
kjfdfdsfdd	interested
kjfdfdsfkjf	interesting
kjfdfjal	internal
kjfdfjafkljal	international
kjfdfjdf	Internet
kjfdf;fdf	interpret
kjfdf;fdfafklj	interpretation
kjfdffdjfklj	intervention
kjfdffkds	interview
kjfl	into
kjffldjdd	introduce
kjffldjdfklj	introduction
kjfasklj	invasion
kjfdsf	invest
kjfdsfkfafd	investigate
kjfdsfkfafklj	investigation
kjfdsfkfaflf	investigator
kjfdsfjdjf	investment
kjfdsflf	investor
kjfkfd	invite
kjfllfd	involve
kjfllfdd	involved
kjfllfdjdjf	involvement
kfaak	Iraqi
kfksj	Irish
kflj	iron
kslajkd	Islamic
kslajd	island
ksfadlk	Israeli
kssjd	issue
kf	it
kfalkaj	Italian
kfdj	item
kfs	its
kfsdlf	itself
jadkdf	jacket
jakl	jail
ja;ajdsd	Japanese
jdf	jet
jds	Jew
jdsksj	Jewish
jlf	job
jlkj	join
jlkjf	joint
jlkd	joke
jljfjal	journal
jljfjalksf	journalist
jljfjdj	journey
jlj	joy
jjdfd	judge
jjdfjdjf	judgment
jjkdd	juice
jjj;	jump
jjjklf	junior
jjfj	jury
jjsf	just
jjsfkdd	justice
jjsfkfj	justify
kdd;	keep
kdj	key
kkdk	kick
kkd	kid
kkll	kill
kklldf	killer
kkllkjf	killing
kkjd	kind
kkjf	king
kkss	kiss
kkfdjdj	kitchen
kjdd	knee
kjkfd	knife
kjldk	knock
kjls	know
kjlslddfd	knowledge
laf	lab
lafdl	label
laflf	labor
laflfaflfj	laboratory
ladk	lack
ladj	lady
lakd	lake
lajd	land
lajdsda;d	landscape
lajfjafd	language
la;	lap
laffd	large
laffdlj	largely
lasf	last
lafd	late
lafdf	later
lafkj	Latin
laffdf	latter
lajfj	laugh
lajjdj	launch
las	law
lasj	lawn
lassjkf	lawsuit
lasjdf	lawyer
laj	lay
lajdf	layer
ldad	lead
ldaddf	leader
ldaddfsjk;	leadership
ldadkjf	leading
ldaf	leaf
ldafjd	league
ldaj	lean
ldafj	learn
ldafjkjf	learning
ldasf	least
ldafjdf	leather
ldafd	leave
ldff	left
ldf	leg
ldfadj	legacy
ldfal	legal
ldfdjd	legend
ldfkslafklj	legislation
ldfkfkjafd	legitimate
ldjlj	lemon
ldjffj	length
ldss	less
ldsslj	lesson
ldf	let
ldffdf	letter
ldfdl	level
lkfdfal	liberal
lkffafj	library
lkddjsd	license
lkd	lie
lkfd	life
lkfdsfjld	lifestyle
lkfdfkjd	lifetime
lkff	lift
lkfjf	light
lkkd	like
lkkdlj	likely
lkjkf	limit
lkjkfafklj	limitation
lkjkfdd	limited
lkjd	line
lkjk	link
lk;	lip
lksf	list
lksfdj	listen
lkfdfallj	literally
lkfdfafj	literary
lkfdfafjfd	literature
lkffld	little
lkfd	live
lkfkjf	living
llad	load
llaj	loan
lldal	local
lldafd	locate
lldafklj	location
lldk	lock
lljf	long
lljf-fdfj	long-term
lllk	look
lllsd	loose
llsd	lose
llss	loss
llsf	lost
llf	lot
llfs	lots
lljd	loud
llfd	love
llfdlj	lovely
llfdf	lover
lls	low
llsdf	lower
ljdk	luck
ljdkj	lucky
ljjdj	lunch
ljjf	lung
jadjkjd	machine
jad	mad
jafaakjd	magazine
jakl	mail
jakj	main
jakjlj	mainly
jakjfakj	maintain
jakjfdjajdd	maintenance
jajlf	major
jajlfkfj	majority
jakd	make
jakdf	maker
jakdj;	makeup
jald	male
jall	mall
jaj	man
jajafd	manage
jajafdjdjf	management
jajafdf	manager
jajjdf	manner
jajjfadfjfdf	manufacturer
jajjfadfjfkjf	manufacturing
jajj	many
ja;	map
jaffkj	margin
jafk	mark
jafkdf	market
jafkdfkjf	marketing
jaffkafd	marriage
jaffkdd	married
jaffj	marry
jask	mask
jass	mass
jasskfd	massive
jasfdf	master
jafdj	match
jafdfkal	material
jafj	math
jaffdf	matter
jaj	may
jajfd	maybe
jajlf	mayor
jd	me
jdal	meal
jdaj	mean
jdajkjf	meaning
jdajsjkld	meanwhile
jdasjfd	measure
jdasjfdjdjf	measurement
jdaf	meat
jddjajksj	mechanism
jddka	media
jddkdal	medical
jddkdafklj	medication
jddkdkjd	medicine
jddkjj	medium
jddf	meet
jddfkjf	meeting
jdjfdf	member
jdjfdfsjk;	membership
jdjlfj	memory
jdjfal	mental
jdjfklj	mention
jdjj	menu
jdfd	mere
jdfdlj	merely
jdss	mess
jdssafd	message
jdfal	metal
jdfdf	meter
jdfjld	method
jdskdaj	Mexican
jkddld	middle
jkfjf	might
jklkfafj	military
jklk	milk
jkllklj	million
jkjd	mind
jkjd	mine
jkjksfdf	minister
jkjlf	minor
jkjlfkfj	minority
jkjjfd	minute
jkfadld	miracle
jkfflf	mirror
jkss	miss
jksskld	missile
jkssklj	mission
jksfakd	mistake
jks	mix
jksfjfd	mixture
jj-jjj	mm-hmm
jldd	mode
jlddl	model
jlddfafd	moderate
jlddfj	modern
jlddsf	modest
jlj	mom
jljdjf	moment
jljdj	money
jljkflf	monitor
jljfj	month
jlld	mood
jllj	moon
jlfal	moral
jlfd	more
jlfdlfdf	moreover
jlfjkjf	morning
jlfffafd	mortgage
jlsf	most
jlsflj	mostly
jlfjdf	mother
jlfklj	motion
jlfkfafklj	motivation
jlflf	motor
jljjf	mount
jljjfakj	mountain
jljsd	mouse
jljfj	mouth
jlfd	move
jlfdjdjf	movement
jlfkd	movie
jf	Mr
jfs	Mrs
js	Ms
jjdj	much
jjlfk;ld	multiple
jjfddf	murder
jjsdld	muscle
jjsdjj	museum
jjskd	music
jjskdal	musical
jjskdkaj	musician
jjslkj	Muslim
jjsf	must
jjfjal	mutual
jj	my
jjsdlf	myself
jjsfdfj	mystery
jjfj	myth
jakdd	naked
jajd	name
jaffafkfd	narrative
jaffls	narrow
jafklj	nation
jafkljal	national
jafkfd	native
jafjfal	natural
jafjfallj	naturally
jafjfd	nature
jdaf	near
jdaffj	nearby
jdaflj	nearly
jdddssafklj	necessarily
jdddssafj	necessary
jddk	neck
jddd	need
jdfafkfd	negative
jdflfkafd	negotiate
jdflfkafklj	negotiation
jdkfjflf	neighbor
jdkfjflfjlld	neighborhood
jdkfjdf	neither
jdffd	nerve
jdffljs	nervous
jdf	net
jdfslfk	network
jdfdf	never
jdfdffjdldss	nevertheless
jds	new
jdslj	newly
jdss	news
jdss;a;df	newspaper
jdsf	next
jkdd	nice
jkfjf	night
jkjd	nine
jl	no
jlfldj	nobody
jld	nod
jlksd	noise
jljkjafklj	nomination
jljd	none
jljdfjdldss	nonetheless
jlf	nor
jlfjal	normal
jlfjallj	normally
jlffj	north
jlffjdfj	northern
jlsd	nose
jlf	not
jlfd	note
jlfjkjf	nothing
jlfkdd	notice
jlfklj	notion
jlfdl	novel
jls	now
jlsjdfd	nowhere
j;f	n't
jjdldaf	nuclear
jjjfdf	number
jjjdfljs	numerous
jjfsd	nurse
jjf	nut
lfjddf	object
lfjddfkfd	objective
lflkfafklj	obligation
lfsdffafklj	observation
lfsdffd	observe
lfsdffdf	observer
lffakj	obtain
lffkljs	obvious
lffkljslj	obviously
lddasklj	occasion
lddaskljallj	occasionally
lddj;afklj	occupation
lddj;j	occupy
lddjf	occur
lddaj	ocean
ldd	odd
ldds	odds
lf	of
lff	off
lffdjsd	offense
lffdjskfd	offensive
lffdf	offer
lffkdd	office
lffkddf	officer
lffkdkal	official
lffdj	often
lj	oh
lkl	oil
lk	ok
lkaj	okay
lld	old
lljj;kd	Olympic
lj	on
ljdd	once
ljd	one
ljflkjf	ongoing
ljklj	onion
ljlkjd	online
ljlj	only
ljfl	onto
l;dj	open
l;djkjf	opening
l;dfafd	operate
l;dfafkjf	operating
l;dfafklj	operation
l;dfaflf	operator
l;kjklj	opinion
l;;ljdjf	opponent
l;;lffjjkfj	opportunity
l;;lsd	oppose
l;;lskfd	opposite
l;;lskfklj	opposition
l;fklj	option
lf	or
lfajfd	orange
lfddf	order
lfdkjafj	ordinary
lffajkd	organic
lffajkaafklj	organization
lffajkad	organize
lfkdjfafklj	orientation
lfkfkj	origin
lfkfkjal	original
lfkfkjallj	originally
lfjdf	other
lfjdfs	others
lfjdfsksd	otherwise
ljfjf	ought
ljf	our
ljfsdlfds	ourselves
ljf	out
ljfdljd	outcome
ljfskdd	outside
lfdj	oven
lfdf	over
lfdfall	overall
lfdfdljd	overcome
lfdflllk	overlook
lsd	owe
lsj	own
lsjdf	owner
;add	pace
;adk	pack
;adkafd	package
;afd	page
;akj	pain
;akjfjl	painful
;akjf	paint
;akjfdf	painter
;akjfkjf	painting
;akf	pair
;ald	pale
;aldsfkjkaj	Palestinian
;alj	palm
;aj	pan
;ajdl	panel
;ajf	pant
;a;df	paper
;afdjf	parent
;afk	park
;afkkjf	parking
;aff	part
;affkdk;ajf	participant
;affkdk;afd	participate
;affkdk;afklj	participation
;affkdjlaf	particular
;affkdjlaflj	particularly
;afflj	partly
;affjdf	partner
;affjdfsjk;	partnership
;affj	party
;ass	pass
;assafd	passage
;assdjfdf	passenger
;assklj	passion
;asf	past
;afdj	patch
;afj	path
;afkdjf	patient
;affdfj	pattern
;ajsd	pause
;aj	pay
;ajjdjf	payment
;d	PC
;dadd	peace
;dak	peak
;ddf	peer
;djalfj	penalty
;dl;ld	people
;d;;df	pepper
;df	per
;dfddkfd	perceive
;dfddjfafd	percentage
;dfdd;fklj	perception
;dffddf	perfect
;dffddflj	perfectly
;dfflfj	perform
;dfflfjajdd	performance
;dfja;s	perhaps
;dfkld	period
;dfjajdjf	permanent
;dfjkssklj	permission
;dfjkf	permit
;dfslj	person
;dfsljal	personal
;dfsljalkfj	personality
;dfsljallj	personally
;dfsljjdl	personnel
;dfs;ddfkfd	perspective
;dfsjadd	persuade
;df	pet
;jasd	phase
;jdjljdjlj	phenomenon
;jkllsl;jj	philosophy
;jljd	phone
;jlfl	photo
;jlflffa;j	photograph
;jlflffa;jdf	photographer
;jfasd	phrase
;jjskdal	physical
;jjskdallj	physically
;jjskdkaj	physician
;kajl	piano
;kdk	pick
;kdfjfd	picture
;kd	pie
;kddd	piece
;kld	pile
;kllf	pilot
;kjd	pine
;kjk	pink
;k;d	pipe
;kfdj	pitch
;ladd	place
;laj	plan
;lajd	plane
;lajdf	planet
;lajjkjf	planning
;lajf	plant
;lasfkd	plastic
;lafd	plate
;lafflfj	platform
;laj	play
;lajdf	player
;ldasd	please
;ldasjfd	pleasure
;ldjfj	plenty
;llf	plot
;ljs	plus
;j	PM
;ldkdf	pocket
;ldj	poem
;ldf	poet
;ldffj	poetry
;lkjf	point
;lld	pole
;llkdd	police
;llkdj	policy
;llkfkdal	political
;llkfkdallj	politically
;llkfkdkaj	politician
;llkfkds	politics
;lll	poll
;llljfklj	pollution
;lll	pool
;llf	poor
;l;	pop
;l;jlaf	popular
;l;jlafklj	population
;lfdj	porch
;lff	port
;lffklj	portion
;lfffakf	portrait
;lfffaj	portray
;lsd	pose
;lskfklj	position
;lskfkfd	positive
;lssdss	possess
;lsskfklkfj	possibility
;lsskfld	possible
;lsskflj	possibly
;lsf	post
;lf	pot
;lfafl	potato
;lfdjfkal	potential
;lfdjfkallj	potentially
;ljjd	pound
;ljf	pour
;lfdffj	poverty
;lsddf	powder
;lsdf	power
;lsdffjl	powerful
;fadfkdal	practical
;fadfkdd	practice
;faj	pray
;fajdf	prayer
;fddksdlj	precisely
;fddkdf	predict
;fdfdf	prefer
;fdfdfdjdd	preference
;fdfjajdj	pregnancy
;fdfjajf	pregnant
;fd;afafklj	preparation
;fd;afd	prepare
;fdsdfk;fklj	prescription
;fdsdjdd	presence
;fdsdjf	present
;fdsdjfafklj	presentation
;fdsdffd	preserve
;fdskddjf	president
;fdskddjfkal	presidential
;fdss	press
;fdssjfd	pressure
;fdfdjd	pretend
;fdffj	pretty
;fdfdjf	prevent
;fdfkljs	previous
;fdfkljslj	previously
;fkdd	price
;fkdd	pride
;fkdsf	priest
;fkjafklj	primarily
;fkjafj	primary
;fkjd	prime
;fkjdk;al	principal
;fkjdk;ld	principle
;fkjf	print
;fklf	prior
;fklfkfj	priority
;fkslj	prison
;fksljdf	prisoner
;fkfadj	privacy
;fkfafd	private
;flfaflj	probably
;flfldj	problem
;fldddjfd	procedure
;fldddd	proceed
;flddss	process
;fldjdd	produce
;fldjddf	producer
;fldjdf	product
;fldjdfklj	production
;flfdssklj	profession
;flfdsskljal	professional
;flfdsslf	professor
;flfkld	profile
;flfkf	profit
;flffaj	program
;flffdss	progress
;fljddf	project
;fljkjdjf	prominent
;fljksd	promise
;fljlfd	promote
;flj;f	prompt
;fllf	proof
;fl;df	proper
;fl;dflj	properly
;fl;dffj	property
;fl;lffklj	proportion
;fl;lsal	proposal
;fl;lsd	propose
;fl;lsdd	proposed
;flsddjflf	prosecutor
;fls;ddf	prospect
;flfddf	protect
;flfddfklj	protection
;flfdkj	protein
;flfdsf	protest
;fljd	proud
;flfd	prove
;flfkdd	provide
;flfkddf	provider
;flfkjdd	province
;flfksklj	provision
;sjdjlllfkdal	psychological
;sjdjlllfksf	psychologist
;sjdjlllfj	psychology
;jflkd	public
;jflkdafklj	publication
;jflkdlj	publicly
;jflksj	publish
;jflksjdf	publisher
;jll	pull
;jjksjjdjf	punishment
;jfdjasd	purchase
;jfd	pure
;jf;lsd	purpose
;jfsjd	pursue
;jsj	push
;jf	put
ajalkfj	qualify
ajalkfj	quality
ajaffdf	quarter
ajaffdffadk	quarterback
ajdsfklj	question
ajkdk	quick
ajkdklj	quickly
ajkdf	quiet
ajkdflj	quietly
ajkf	quit
ajkfd	quite
ajlfd	quote
fadd	race
fadkal	racial
fadkdal	radical
fadkl	radio
fakl	rail
fakj	rain
faksd	raise
fajfd	range
fajk	rank
fa;kd	rapid
fa;kdlj	rapidly
fafd	rare
fafdlj	rarely
fafd	rate
fafjdf	rather
fafkjf	rating
fafkl	ratio
fas	raw
fdadj	reach
fdadf	react
fdadfklj	reaction
fdad	read
fdaddf	reader
fdadkjf	reading
fdadj	ready
fdal	real
fdalkfj	reality
fdalkad	realize
fdallj	really
fdaslj	reason
fdasljafld	reasonable
fddall	recall
fdddkfd	receive
fdddjf	recent
fdddjflj	recently
fddk;d	recipe
fddlfjkfklj	recognition
fddlfjkad	recognize
fddljjdjd	recommend
fddljjdjdafklj	recommendation
fddlfd	record
fddlfdkjf	recording
fddlfdf	recover
fddlfdfj	recovery
fddfjkf	recruit
fdd	red
fddjdd	reduce
fddjdfklj	reduction
fdfdf	refer
fdfdfdjdd	reference
fdflddf	reflect
fdflddfklj	reflection
fdflfj	reform
fdfjfdd	refugee
fdfjsd	refuse
fdfafd	regard
fdfafdkjf	regarding
fdfafdldss	regardless
fdfkjd	regime
fdfklj	region
fdfkljal	regional
fdfksfdf	register
fdfjlaf	regular
fdfjlaflj	regularly
fdfjlafd	regulate
fdfjlafklj	regulation
fdkjflfdd	reinforce
fdjddf	reject
fdlafd	relate
fdlafklj	relation
fdlafkljsjk;	relationship
fdlafkfd	relative
fdlafkfdlj	relatively
fdlas	relax
fdldasd	release
fdldfajf	relevant
fdlkdf	relief
fdlkfklj	religion
fdlkfkljs	religious
fdlj	rely
fdjakj	remain
fdjakjkjf	remaining
fdjafkafld	remarkable
fdjdjfdf	remember
fdjkjd	remind
fdjlfd	remote
fdjlfd	remove
fd;daf	repeat
fd;dafddlj	repeatedly
fd;ladd	replace
fd;lj	reply
fd;lff	report
fd;lffdf	reporter
fd;fdsdjf	represent
fd;fdsdjfafklj	representation
fd;fdsdjfafkfd	representative
fd;jflkdaj	Republican
fd;jfafklj	reputation
fdajdsf	request
fdajkfd	require
fdajkfdjdjf	requirement
fdsdafdj	research
fdsdafdjdf	researcher
fdsdjfld	resemble
fdsdffafklj	reservation
fdskddjf	resident
fdsksf	resist
fdsksfajdd	resistance
fdslljfklj	resolution
fdsllfd	resolve
fdslff	resort
fdsljfdd	resource
fds;ddf	respect
fds;ljd	respond
fds;ljddjf	respondent
fds;ljsd	response
fds;ljskfklkfj	responsibility
fds;ljskfld	responsible
fdsf	rest
fdsfajfajf	restaurant
fdsflfd	restore
fdsffkdfklj	restriction
fdsjlf	result
fdfakj	retain
fdfkfd	retire
fdfkfdjdjf	retirement
fdfjfj	return
fdfdal	reveal
fdfdjjd	revenue
fdfkds	review
fdflljfklj	revolution
fjjfjj	rhythm
fkdd	rice
fkdj	rich
fkd	rid
fkdd	ride
fkfld	rifle
fkfjf	right
fkjf	ring
fksd	rise
fksk	risk
fkfdf	river
flad	road
fldk	rock
flld	role
flll	roll
fljajfkd	romantic
fllf	roof
fllj	room
fllf	root
fl;d	rope
flsd	rose
fljfj	rough
fljfjlj	roughly
fljjd	round
fljfd	route
fljfkjd	routine
fls	row
fjf	rub
fjld	rule
fjj	run
fjjjkjf	running
fjfal	rural
fjsj	rush
fjsskaj	Russian
sadfdd	sacred
sad	sad
safd	safe
safdfj	safety
sakd	sake
salad	salad
salafj	salary
sald	sale
salds	sales
salf	salt
sajd	same
saj;ld	sample
sajdfklj	sanction
sajd	sand
safdllkfd	satellite
safksfadfklj	satisfaction
safksfj	satisfy
sajdd	sauce
safd	save
safkjf	saving
saj	say
sdald	scale
sdajdal	scandal
sdafdd	scared
sddjafkl	scenario
sddjd	scene
sdjddjld	schedule
sdjdjd	scheme
sdjllaf	scholar
sdjllafsjk;	scholarship
sdjlll	school
sdkdjdd	science
sdkdjfkfkd	scientific
sdkdjfksf	scientist
sdl;d	scope
sdlfd	score
sdfdaj	scream
sdfddj	screen
sdfk;f	script
sda	sea
sdafdj	search
sdaslj	season
sdaf	seat
sddljd	second
sddfdf	secret
sddfdfafj	secretary
sddfklj	section
sddflf	sector
sddjfd	secure
sddjfkfj	security
sdd	see
sddd	seed
sddk	seek
sddj	seem
sdfjdjf	segment
sdkad	seize
sdlddf	select
sdlddfklj	selection
sdlf	self
sdll	sell
sdjafd	Senate
sdjaflf	senator
sdjd	send
sdjklf	senior
sdjsd	sense
sdjskfkfd	sensitive
sdjfdjdd	sentence
sd;afafd	separate
sdajdjdd	sequence
sdfkds	series
sdfkljs	serious
sdfkljslj	seriously
sdffd	serve
sdffkdd	service
sdssklj	session
sdf	set
sdffkjf	setting
sdffld	settle
sdffldjdjf	settlement
sdfdj	seven
sdfdfal	several
sdfdfd	severe
sds	sex
sdsjal	sexual
sjadd	shade
sjadls	shadow
sjakd	shake
sjall	shall
sja;d	shape
sjafd	share
sjaf;	sharp
sjd	she
sjddf	sheet
sjdlf	shelf
sjdll	shell
sjdlfdf	shelter
sjkff	shift
sjkjd	shine
sjk;	ship
sjkff	shirt
sjkf	shit
sjldk	shock
sjld	shoe
sjllf	shoot
sjllfkjf	shooting
sjl;	shop
sjl;;kjf	shopping
sjlfd	shore
sjlff	short
sjlfflj	shortly
sjlf	shot
sjljld	should
sjljlddf	shoulder
sjljf	shout
sjls	show
sjlsdf	shower
sjfjf	shrug
sjjf	shut
skdk	sick
skdd	side
skfj	sigh
skfjf	sight
skfj	sign
skfjal	signal
skfjkfkdajdd	significance
skfjkfkdajf	significant
skfjkfkdajflj	significantly
skldjdd	silence
skldjf	silent
sklfdf	silver
skjklaf	similar
skjklaflj	similarly
skj;ld	simple
skj;lj	simply
skj	sin
skjdd	since
skjf	sing
skjfdf	singer
skjfld	single
skjk	sink
skf	sir
sksfdf	sister
skf	sit
skfd	site
skfjafklj	situation
sks	six
skad	size
skk	ski
skkll	skill
skkj	skin
skj	sky
slafd	slave
sldd;	sleep
slkdd	slice
slkdd	slide
slkfjf	slight
slkfjflj	slightly
slk;	slip
slls	slow
sllslj	slowly
sjall	small
sjaff	smart
sjdll	smell
sjkld	smile
sjlkd	smoke
sjllfj	smooth
sja;	snap
sjls	snow
sl	so
sl-dalldd	so-called
sldddf	soccer
sldkal	social
sldkdfj	society
slff	soft
slffsafd	software
slkl	soil
sllaf	solar
slldkdf	soldier
sllkd	solid
slljfklj	solution
sllfd	solve
sljd	some
sljdfldj	somebody
sljdjls	somehow
sljdljd	someone
sljdfjkjf	something
sljdfkjds	sometimes
sljdsjaf	somewhat
sljdsjdfd	somewhere
slj	son
sljf	song
sllj	soon
sl;jksfkdafdd	sophisticated
slffj	sorry
slff	sort
sljl	soul
sljjd	sound
slj;	soup
sljfdd	source
sljfj	south
sljfjdfj	southern
slfkdf	Soviet
s;add	space
s;ajksj	Spanish
s;dak	speak
s;dakdf	speaker
s;ddkal	special
s;ddkalksf	specialist
s;ddkds	species
s;ddkfkd	specific
s;ddkfkdallj	specifically
s;dddj	speech
s;ddd	speed
s;djd	spend
s;djdkjf	spending
s;kj	spin
s;kfkf	spirit
s;kfkfjal	spiritual
s;lkf	split
s;lkdsjaj	spokesman
s;lff	sport
s;lf	spot
s;fdad	spread
s;fkjf	spring
sajafd	square
sajddad	squeeze
sfafklkfj	stability
sfafld	stable
sfaff	staff
sfafd	stage
sfakf	stair
sfakd	stake
sfajd	stand
sfajdafd	standard
sfajdkjf	standing
sfaf	star
sfafd	stare
sfaff	start
sfafd	state
sfafdjdjf	statement
sfafklj	station
sfafksfkds	statistics
sfafjs	status
sfaj	stay
sfdadj	steady
sfdal	steal
sfddl	steel
sfd;	step
sfkdk	stick
sfkll	still
sfkf	stir
sfldk	stock
sfljadj	stomach
sfljd	stone
sfl;	stop
sflfafd	storage
sflfd	store
sflfj	storm
sflfj	story
sffakfjf	straight
sffajfd	strange
sffajfdf	stranger
sffafdfkd	strategic
sffafdfj	strategy
sffdaj	stream
sffddf	street
sffdjffj	strength
sffdjffjdj	strengthen
sffdss	stress
sffdfdj	stretch
sffkkd	strike
sffkjf	string
sffk;	strip
sfflkd	stroke
sffljf	strong
sffljflj	strongly
sffjdfjfd	structure
sffjffld	struggle
sfjddjf	student
sfjdkl	studio
sfjdj	study
sfjff	stuff
sfj;kd	stupid
sfjld	style
sjfjddf	subject
sjfjkf	submit
sjfsdajdjf	subsequent
sjfsfajdd	substance
sjfsfajfkal	substantial
sjddddd	succeed
sjdddss	success
sjdddssfjl	successful
sjdddssfjllj	successfully
sjdj	such
sjdddj	sudden
sjdddjlj	suddenly
sjd	sue
sjffdf	suffer
sjffkdkdjf	sufficient
sjfaf	sugar
sjffdsf	suggest
sjffdsfklj	suggestion
sjkdkdd	suicide
sjkf	suit
sjjjdf	summer
sjjjkf	summit
sjj	sun
sj;df	super
sj;;lj	supply
sj;;lff	support
sj;;lffdf	supporter
sj;;lsd	suppose
sj;;lsdd	supposed
sj;fdjd	Supreme
sjfd	sure
sjfdlj	surely
sjffadd	surface
sjffdfj	surgery
sjf;fksd	surprise
sjf;fksdd	surprised
sjf;fkskjf	surprising
sjf;fkskjflj	surprisingly
sjffljjd	surround
sjffdj	survey
sjffkfal	survival
sjffkfd	survive
sjffkflf	survivor
sjs;ddf	suspect
sjsfakj	sustain
ssdaf	swear
ssdd;	sweep
ssddf	sweet
sskj	swim
sskjf	swing
sskfdj	switch
sjjfll	symbol
sjj;flj	symptom
sjsfdj	system
fafld	table
faflds;llj	tablespoon
fadfkd	tactic
fakl	tail
fakd	take
fald	tale
faldjf	talent
falk	talk
fall	tall
fajk	tank
fa;	tap
fa;d	tape
faffdf	target
fask	task
fasfd	taste
fas	tax
fas;ajdf	taxpayer
fda	tea
fdadj	teach
fdadjdf	teacher
fdadjkjf	teaching
fdaj	team
fdaf	tear
fdas;llj	teaspoon
fddjjkdal	technical
fddjjkajd	technique
fddjjlllfj	technology
fddj	teen
fddjafdf	teenager
fdld;jljd	telephone
fdldsdl;d	telescope
fdldfksklj	television
fdll	tell
fdj;dfafjfd	temperature
fdj;lfafj	temporary
fdj	ten
fdjd	tend
fdjddjdj	tendency
fdjjks	tennis
fdjsklj	tension
fdjf	tent
fdfj	term
fdfjs	terms
fdffkfld	terrible
fdffkflfj	territory
fdfflf	terror
fdfflfksj	terrorism
fdfflfksf	terrorist
fdsf	test
fdsfkfj	testify
fdsfkjljj	testimony
fdsfkjf	testing
fdsf	text
fjaj	than
fjajk	thank
fjajks	thanks
fjaf	that
fjd	the
fjdafdf	theater
fjdkf	their
fjdj	them
fjdjd	theme
fjdjsdlfds	themselves
fjdj	then
fjdlfj	theory
fjdfa;j	therapy
fjdfd	there
fjdfdflfd	therefore
fjdsd	these
fjdj	they
fjkdk	thick
fjkj	thin
fjkjf	thing
fjkjk	think
fjkjkkjf	thinking
fjkfd	third
fjkffj	thirty
fjks	this
fjlsd	those
fjljfj	though
fjljfjf	thought
fjljsajd	thousand
fjfdaf	threat
fjfdafdj	threaten
fjfdd	three
fjflaf	throat
fjfljfj	through
fjfljfjljf	throughout
fjfls	throw
fjjs	thus
fkdkdf	ticket
fkd	tie
fkfjf	tight
fkjd	time
fkjj	tiny
fk;	tip
fkfd	tire
fkfdd	tired
fkssjd	tissue
fkfld	title
fl	to
flfaddl	tobacco
fldaj	today
fld	toe
flfdfjdf	together
fljafl	tomato
fljlffls	tomorrow
fljd	tone
fljfjd	tongue
fljkfjf	tonight
fll	too
flll	tool
fllfj	tooth
fl;	top
fl;kd	topic
flss	toss
flfal	total
flfallj	totally
fljdj	touch
fljfj	tough
fljf	tour
fljfksf	tourist
fljfjajdjf	tournament
flsafd	toward
flsafds	towards
flsdf	tower
flsj	town
flj	toy
ffadd	trace
ffadk	track
ffadd	trade
ffadkfklj	tradition
ffadkfkljal	traditional
ffaffkd	traffic
ffafddj	tragedy
ffakl	trail
ffakj	train
ffakjkjf	training
ffajsfdf	transfer
ffajsflfj	transform
ffajsflfjafklj	transformation
ffajskfklj	transition
ffajslafd	translate
ffajs;lffafklj	transportation
ffafdl	travel
ffdaf	treat
ffdafjdjf	treatment
ffdafj	treaty
ffdd	tree
ffdjdjdljs	tremendous
ffdjd	trend
ffkal	trial
ffkfd	tribe
ffkdk	trick
ffk;	trip
ffll;	troop
ffljfld	trouble
ffjdk	truck
ffjd	true
ffjlj	truly
ffjsf	trust
ffjfj	truth
ffj	try
fjfd	tube
fjjjdl	tunnel
fjfj	turn
ff	TV
fsdlfd	twelve
fsdjfj	twenty
fskdd	twice
fskj	twin
fsl	two
fj;d	type
fj;kdal	typical
fj;kdallj	typically
jflj	ugly
jlfkjafd	ultimate
jlfkjafdlj	ultimately
jjafld	unable
jjdld	uncle
jjddf	under
jjddffl	undergo
jjddfsfajd	understand
jjddfsfajdkjf	understanding
jjflffjjafdlj	unfortunately
jjkflfj	uniform
jjklj	union
jjkajd	unique
jjkf	unit
jjkfdd	United
jjkfdfsal	universal
jjkfdfsd	universe
jjkfdfskfj	university
jjkjlsj	unknown
jjldss	unless
jjlkkd	unlike
jjlkkdlj	unlikely
jjfkl	until
jjjsjal	unusual
j;	up
j;lj	upon
j;;df	upper
jffaj	urban
jffd	urge
js	us
jsd	use
jsdd	used
jsdfjl	useful
jsdf	user
jsjal	usual
jsjallj	usually
jfklkfj	utility
fadafklj	vacation
falldj	valley
faljafld	valuable
faljd	value
fafkafld	variable
fafkafklj	variation
fafkdfj	variety
fafkljs	various
fafj	vary
fasf	vast
fdfdfafld	vegetable
fdjkdld	vehicle
fdjfjfd	venture
fdfsklj	version
fdfsjs	versus
fdfj	very
fdssdl	vessel
fdfdfaj	veteran
fka	via
fkdfkj	victim
fkdflfj	victory
fkddl	video
fkds	view
fkdsdf	viewer
fkllafd	village
fkllafd	violate
fkllafklj	violation
fklldjdd	violence
fklldjf	violent
fkffjallj	virtually
fkffjd	virtue
fkfjs	virus
fkskfld	visible
fksklj	vision
fkskf	visit
fkskflf	visitor
fksjal	visual
fkfal	vital
flkdd	voice
flljjd	volume
flljjfddf	volunteer
flfd	vote
flfdf	voter
fs	vs
fjljdfafld	vulnerable
safd	wage
sakf	wait
sakd	wake
salk	walk
sall	wall
sajddf	wander
sajf	want
saf	war
safj	warm
safj	warn
safjkjf	warning
sasj	wash
sasfd	waste
safdj	watch
safdf	water
safd	wave
saj	way
sd	we
sdak	weak
sdalfj	wealth
sdalfjj	wealthy
sda;lj	weapon
sdaf	wear
sdafjdf	weather
sdddkjf	wedding
sddk	week
sddkdjd	weekend
sddklj	weekly
sdkfj	weigh
sdkfjf	weight
sdldljd	welcome
sdlfafd	welfare
sdll	well
sdsf	west
sdsfdfj	western
sdf	wet
sjaf	what
sjafdfdf	whatever
sjddl	wheel
sjdj	when
sjdjdfdf	whenever
sjdfd	where
sjdfdas	whereas
sjdfjdf	whether
sjkdj	which
sjkld	while
sjks;df	whisper
sjkfd	white
sjl	who
sjlld	whole
sjlj	whom
sjlsd	whose
sjj	why
skdd	wide
skddlj	widely
skdds;fdad	widespread
skfd	wife
skld	wild
skll	will
skllkjf	willing
skj	win
skjd	wind
skjdls	window
skjd	wine
skjf	wing
skjjdf	winner
skjfdf	winter
sk;d	wipe
skfd	wire
sksdlj	wisdom
sksd	wise
sksj	wish
skfj	with
skfjdfas	withdraw
skfjkj	within
skfjljf	without
skfjdss	witness
sljaj	woman
sljddf	wonder
sljddffjl	wonderful
slld	wood
sllddj	wooden
slfd	word
slfk	work
slfkdf	worker
slfkkjf	working
slfks	works
slfksjl;	workshop
slfld	world
slffkdd	worried
slffj	worry
slffj	worth
sljld	would
sljjd	wound
sfa;	wrap
sfkfd	write
sfkfdf	writer
sfkfkjf	writing
sfljf	wrong
jafd	yard
jdaj	yeah
jdaf	year
jdll	yell
jdllls	yellow
jds	yes
jdsfdfdaj	yesterday
jdf	yet
jkdld	yield
jlj	you
jljjf	young
jljf	your
jljfs	yours
jljfsdlf	yourself
jljfj	youth
aljd	zone
